khoai to | [Đúng là khoai bự thiệt rồi, nhìn mà bất ngờ hết hồn luôn á|Khoai này bự dữ lắm, hiếm thấy luôn nha|To quá trời quá đất, ai nhìn cũng phải trầm trồ khen ngợi]
xin code | [Bạn cứ nhắn tin trực tiếp vào Fanpage, bên mình sẽ gửi Code ngay trong hộp thư liền cho tiện nha|Code thì ib fanpage gấp đi, bên mình trả lời nhanh lắm đó|Bạn muốn nhận code thì chỉ cần ib cho fanpage, mình sẽ gửi ngay lập tức]
that | [Thật 100% luôn, đảm bảo không có chuyện nói giỡn đâu|Chuẩn thật sự luôn, mình nói thiệt chứ không có chém gió|Yên tâm đi, mình khẳng định đây là sự thật hoàn toàn]
tin chuan | [Chuẩn khỏi bàn cãi luôn rồi đó bạn ơi|Chuẩn rồi đó, yên tâm tuyệt đối nha không sai đâu|Thông tin chính xác tuyệt đối, không lệch một ly]
chac khong | [Chắc chắn luôn rồi, bạn không cần phải nghi ngờ đâu|Không chắc thì còn gì nữa, bảo đảm tuyệt đối nha|Yên tâm đi, mình khẳng định chắc như bắp]
hay | [Game này vừa hay vừa chất lượng, ai chơi cũng mê mẩn|Đã hay lại còn cực kỳ cuốn hút, chơi là ghiền luôn|Phải gọi là siêu hay, nhiều người khen lắm rồi đó]
biet | [Cái này ai cũng biết hết trơn á, thông tin rõ ràng mà|Chuyện này mình rành lắm rồi, biết từ A tới Z luôn|Biết hết mọi thứ rồi, không sót gì đâu nha]
chat luong | [Game chất lượng cao thì mới có nhiều người chơi đông vui như vậy|Chuẩn bài luôn, chơi là thấy mượt mà xịn sò ngay|Uy tín lắm nên cộng đồng mới gắn bó lâu dài]
doc la | [Game này độc lạ, chơi không cần mở thành viên vẫn vui|Độc lạ có một không hai, hiếm có chỗ nào có kiểu này|Thật sự cực dị luôn, đúng chất trải nghiệm mới mẻ]
fan cung | [Bạn chịu khó tương tác thường xuyên thì Facebook sẽ tự động cho lên fan cứng ngay thôi|Tích cực comment, thả cảm xúc thì sớm muộn gì cũng thành fan cứng|Cày tương tác đều đều, fan cứng chắc chắn thuộc về bạn]
ok | [Quá chất lượng luôn, không cần phải chỉnh gì thêm hết|Chuẩn xác tuyệt đối, khỏi bàn thêm nữa|Perfect luôn đó, nghe là thấy uy tín rồi]
code moi | [Bạn chỉ cần lướt fanpage là sẽ thấy bài viết chứa code mới update rồi đó|Fanpage vừa đăng code mới nóng hổi cho mọi người, vào xem ngay nha|Code mới vừa được cập nhật trên fanpage, đừng bỏ lỡ cơ hội nhận liền]
bip | [Không hề có bịp gì hết, đảm bảo uy tín 100% luôn nha|Ai mà bịp bao giờ, yên tâm chơi thoải mái đi bạn|Yên tâm tuyệt đối, không hề có bịp, thử là biết liền]
tuyet | [Tuyệt vời ông mặt trời luôn, không chê vào đâu được|Quá tuyệt vời rồi, ai chơi cũng khen nức nở|Xịn thật sự, trải nghiệm một lần là nhớ mãi], nhớ rủ bạn bè trải nghiệm chung cho vui hơn
ngon | [Ngon thiệt sự luôn đó, chơi một lần là phê muốn chơi tiếp hoài|Ngon cực kỳ, đông người vào chơi chung nên rất vui|Ngon số dzách luôn, ai cũng đang rủ bạn bè vào thử]. Đông vui khỏi bàn
huong dan | Vô ngay trang chủ là có [hướng dẫn chi tiết|tutorial cụ thể] trong [diễn đàn|forum chính thức] đó bạn
bao gio | [Sắp có rồi nha, chuẩn bị là ra liền|Gần có rồi, bạn chờ xíu thôi|Đang chuẩn bị ra mắt luôn, sắp được trải nghiệm rồi]
qua da | [Đã quá xá luôn, phê tới nóc|Cảm giác quá tuyệt, khó tả luôn|Quá đã luôn rồi, chơi là mê ngay lập tức]
alo | [Alo alo nghe rõ trả lời luôn nha|Alo có chuyện gì vậy bạn ơi|Alo alo có gì hông nà]
vai | [Thua luôn với độ bá đạo này, vãi thiệt chứ|Vãi thiệt rồi, không ngờ luôn á|Vãi dễ sợ, kkk cười xỉu]
yeu | [Mãi yêu game này luôn, không bỏ được|Yêu hết nấc rồi, thương quá đi thôi|Thương ghê á, nhớ rủ bạn bè chơi chung cho vui nghen]
hong | [Lót dép ngồi hóng chung cho đủ bộ|Ngồi hóng từng giây từng phút nè|Hóng hớt dữ dội luôn, chờ phát ra liền]
link | Trên fanpage đã có [link rõ ràng cho bạn|đường dẫn sẵn rồi|link cụ thể kìa] bạn chỉ cần nhấn vô là được
hup hup | [Húp sùn sụt luôn cho nóng hổi|Húp lẹ lẹ đi kẻo nguội nha|Húp nhiệt tình vô, đã lắm đó]
hup | [Húp sùn sụt luôn nghe đã tai|Húp lẹ lẹ đi cho nóng sốt|Húp nhiệt tình vô, cảm giác cực phê]
hupp | [Húp sùn sụt cho sung sướng luôn|Húp lẹ cho ngon lành cành đào|Húp nhiệt tình để cảm nhận trọn vị]
huppp | [Húp sùn sụt đã đời luôn|Húp lẹ lẹ đừng chần chừ|Húp nhiệt tình quá trời luôn]
. | [Chúc bạn một ngày vui vẻ nhen, nhiều niềm vui mới|Chúc ngày mới của bạn thật nhiều năng lượng tích cực|Ngày hôm nay chill nhẹ nhàng, bình an nha 🌸]
cuon qua | [Quá cuốn luôn, khó dứt ra nổi|Bánh cuốn nóng hổi còn thua độ cuốn này|Cuốn tới mức ngồi chơi quên cả giờ luôn]
hmm | [Cuốn quá trời chứ còn gì nữa|Hay tới mức khó tin luôn á|Húp ngay kẻo lỡ, ngon lắm]
mup | [Húp rụp một phát là ghiền liền|Múp rụp ngon lành luôn má ơi|Múp quá ngon rồi, không cưỡng lại nổi]
wow | [Wow, nhìn mà mê luôn 🥰|Ngon dữ dội 🤗|Quá đã, không chê vào đâu được]
ec | [Wow tuyệt vời luôn 🥰|Ngon cực kỳ 🤗|Đã quá trời rồi, phê thiệt sự]
tui me cu | [Sai rồi má, nói kiểu này là dark quá luôn|Nghĩ gì mà dark dữ vậy nè|Thật sự quá damdang rồi, cẩn thận nha]
muc tieu | [Chuẩn xác như mục tiêu đã định luôn|Quá dữ dằn, đạt target rồi đó|Ghê vậy má, bắn trúng đích liền]
hehe | [Hehe, ngon hông má, nhìn là biết liền|Rủ thêm bạn bè vô chơi cho đông vui đi|Hehe, kêu bạn bè vô chung cho zui hơn nữa]
chao | [Chào bạn nha, chúc ngày mới thật nhiều niềm vui|Chúc bạn một ngày tràn đầy năng lượng tích cực và niềm vui|Ngày mới hạnh phúc, làm gì cũng suôn sẻ và may mắn nha]
troi | [Trời trời, không ngờ luôn á|Không nghĩ được như vậy chứ gì|Quá dark rồi, sốc tận óc luôn]
:)) | [:v|:))|:((]
vao thoi | [Vào thôi nào, chuẩn bị chiến liền|Vào ngay đi cho nóng, chậm chân là tiếc á|Rủ thêm bạn bè vô ngay để chơi chung cho vui nha]
ne | [Nể thiệt sự luôn đó, không nói xạo|Nể quá trời, đúng chất|Má ơi nể dữ dằn luôn]
ke | [Nể ghê luôn á, phục sát đất|Quá nể rồi, đúng bài luôn|Má nể dữ lắm đó]
chiu | [Nói vậy thì mình cũng chịu thua luôn|Chịu lun không cãi được|Thua thiệt rồi, hết cách luôn]
kol | [Hóng nhiệm vụ KOL quá trời, chờ từng ngày luôn|Hóng mãi từ bữa giờ, tới khi nào ra đây|Lót dép chờ KOL xuất hiện, nhớ rủ bạn bè vô cho vui!]
kk | [Kk cái gì má, cười xỉu|Kaka, nghe mắc cười|Haha, vui ghê á]
kkk | [Kk cái gì nữa, cười quá trời|Kaka, trò này hài ghê|Haha, đúng kiểu giải trí]
uh | [🤣 haha đúng rồi|😂 chuẩn luôn|😘 thương lắm đó]
nung | [Nung ác luôn, húp liền cho nóng|Húp luôn cho phê, khỏi chờ|Quá đã luôn má, nóng hổi vừa thổi vừa ăn]
san sang | [Tui hóng sẵn sàng lâu rồi đây, vô chiến liền|Kêu thêm bạn bè cùng sẵn sàng cho vui nha|Chuẩn bị hết rồi, sẵn sàng chơi chung thôi]
bu bu | [Ngon lành cành đào, húp liền cho đã|Ngon quá còn gì nữa đâu mà chờ|Húp trọn vẹn cảm giác ngon ngất ngây]
qua du | [Dữ dằn quá trời má ơi, coi bộ ghê á|Dữ thiệt chứ không giỡn đâu, haha|Còn dữ nữa, chờ tiếp phần sau nè kaka]
hi | [Hi lô bạn ơi, lâu quá mới gặp|Hi le nha, chúc ngày mới vui vẻ|Hi la, chào thân ái nhen]
Het nuoc cham | [Chấm mắm hay tương để tui làm liền cho bạn húp nè|Có ăn bún không, tui chế thêm chén mắm tỏi ớt thơm lừng luôn|Hết nước chấm thì đưa đây, tui pha miếng tương đậu đậm vị liền]
nhieu sv | [Nhiều server lắm, bạn thích cái nào thì chọn cái đó chơi cho tiện|Đông người thì mới vui chứ, tha hồ lựa server|Cái nào cũng ngon hết, bạn ưng cái nào thì vô ngay cái đó]
chien | [Chiến liền cho nóng tay đi bạn|Chiến ngay lập tức, không chờ nữa|Rủ bạn bè zô chiến cho vui hơn nè]
ghe | [Ghê vậy thì cho xin một like đi má|Ghê hông, cười xỉu luôn kkk|Quá ghê rồi, đúng chất bá đạo luôn]
